+-+-+-+-+-+-+-+-+-+-+
E   |       |   |   |
+-+ + +-+-+ +-+ + + +
| | | |   | |     | |
+ + + +-+ + + + +-+-+
| |   | |     | |   |
+ +-+ +-+-+-+-+ + + +
|   | |     |   | | |
+-+ + + + +-+ +-+ + +
| | |   | | |   | | |
+ + +-+-+ +-+-+ +-+ +
|   |     |   |     |
+-+-+ + +-+ + +-+ +-+
|   | |   | |   |   |
+-+ + +-+ + +-+ +-+-+
|   | |     | |     |
+ +-+ +-+ +-+-+-+-+ +
|   |         |     |
+ + +-+-+ + + +-+-+-+
| |     |   |       S
+-+-+-+-+-+-+-+-+-+-+
