+--+--+--+--+--+--+--+--+--+--+
E     |           |     |     |
+  +  +  +--+--+  +--+  +  +  +
|  |  |  |     |  |        |  S
+  +  +--+  +  +  +  +  +--+--+
|  |        |        |  |     |
+  +--+  +--+--+--+--+  +  +  +
|     |  |        |     |  |  |
+--+  +  +  +--+  +  +--+  +  +
|  |  |     |     |     |  |  |
+  +  +--+--+  +--+--+  +--+  +
|     |        |     |        |
+--+--+  +--+--+  +  +--+  +--+
|     |  |     |  |     |     |
+--+  +  +--+  +  +--+  +--+--+
|     |  |        |  |        |
+  +--+  +  +--+--+  +--+--+  +
|        |  |        |        |
+  +  +--+  +  +--+--+  +--+--+
|  |        |                 |
+--+--+--+--+--+--+--+--+--+--+